XXXXXXXXXXXXXXXXXXXXXXXXXXXXXXXXXXXXXXXXXXXXXXXXXXXXXXXXXXXXXXXXXXXXXXXXXXXXXXXXX
XXXXX     XXX    XXXXXXXXX                  XXXXXXXXXXXXX                    XXXX
XXXXX XXX XXX XX   XXXXXXX XXXXXXXXXXXXXXXX XXXXX      XX XXXXXXXXXXXXXXXXXXXXXXX
X     X   XXX XX X XXXXXXX XXXXXXXXXXXXXXXX XXXXX XXXX XX XXX            XXXXXXXX
XXXXX XXXXXXXXXX XXXXXXXXX XX               XXXXX XXXX XX XXX XXXXXXXXXX XX   XXX
XXX                   XXXX XX XXXXXXXXXXXXXXXXXXX XXXX XX XXX XXXX XXXXX XX X XXX
XXX XX XXXXXXXXXXXXXXXXXXX XX         XXXXXXXXXXX XXXX XX XXX XXXX XXXXX    X XXX
XXX XX X X            XXXX XXXXXXXXXX XXXX XXXXXX XXXX XX XXX XXXX XXXXXXXXXX XXX
XXX XX X X XXXXXXXXXX XXXX XXX        XXXX XXXXXX XXXX XX XXX XXXX XXXXXXXXXX XXX
XXX XX X X       XXXX XXXX XXX XXXXXXXXXXX XXXXXX XXXX XX XXX XXXX XXXXXXXXXX   F
XXX XX X X XXXXX XXXX XX   XXX XXXXXXXXXXX XXXXXX XXXX XX XXX XX            XXXXX
XXX XX X X XX XX XXXX XXXX XXX XXXXXXXXXXX XXXXXX XXXX XX XXX XX XXXXXXXXXX XXXXX
XXX XX X X XX XX XXXX XXXX XXX                    XXXX XX XXX XX X        X XXXXX
XXX XX X      XX XXXX XXXX XXXXXXXXXX XXXXXXXXXXXXXXXX XX XXX XX X XXXXXX X XXXXX
XXX XX X XXXX XX XXXX X    XXXX XXXXX XX        XXXXXX XX XXX XX X X   XX X XXXXX
XXX XX XXXXXXXXX XXXX XXXX XXXX XXXXX XXXXXXXXX XXXXXX XX XXX XX X X X XX X XXXXX
XXX XX           XXXX XXXX XXXX XXXXX XXXXXXXXX XXXXXX XX XXX XX X X X XX X XXXXX
XXX XXXXXXXXXXXXXXXXX XXXX XX                   XXXXXX XX XXX XX X X X XX X XXXXX
XXX XXXXXXXXXXXXXXXXX XXXX XX XXXXXXXXXXXXXXXXXXXXXXXX XX XXX XX X X X XX X XXXXX
XXX XXX               XXXX XX XXXXXXXXXXXXXXXXXXXXXXXX XX XXX XX X X X XX X XXXXX
XXX XXX XXXXXXXXXXXXXXXXXX XX XXX                      XX XXX XX X X X  X X XXXXX
XXX XXX              XXXXX XX XXX XXXXXXXXXXXXXXXXXXXXXXX XXX XX X X XXXX X XXXXX
XXX XXXXXXXXXXXXXXXX XXXXX XX XXX XXXXX XXX XXXXXX XXXXX  XXX XX X X      X XXXXX
XXX XXXXXXX          XXXXX XX XXX XXXXX XXX XXXXXX XXXXX XXXX XX X XXXXXXXX XXXXX
XXX XXXXXXX XXXX XXXXXXXXX XX XXX                             XX X          XXXXX
XXX      XX X XX XXXX XXXX XX XXXXXXXXXXXXXXXXXXXXXXXXXXXXXXXXXX XXXXXXXXXXXXXXXX
S   XX XXXX X         XXXX XX                                             XXXXXXX
XXXXXX XXXX XXXXXXXXXXXXXX XXXXXXXXXXXXXXXXX XXXXXXXXXXXXXXXXXXXXXXXXXXXXXXXXXXXX
XX       XX                XX                                                  XX
XXXXXXXXXXXXXXXXXXXXXXXXXXXXXXXXXXXXXXXXXXXXXXXXXXXXXXXXXXXXXXXXXXXXXXXXXXXXXXXXX